9 10
WWWWWWWWWW
WP......CW
W.W.W.W..W
W....K...W
W.WWWWW..W
W....G...W
W.W.W.W..W
WC......CW
WWWWWWWWWW
